NO ./textures/the_north_texture.xpm
SO ./textures/the_south_texture.xpm
WE ./textures/the_west_texture.xpm
EA ./textures/the_east_texture.xpm

F 199,220,227
C 149,226,250

11111111111111111
111111W1111111111
11111111111111111