NO ./textures/the_north_texture.xpm
SO ./textures/the_south_texture.xpm
WE ./textures/the_west_texture.xpm
EA ./textures/the_east_texture.xpm

F 220,100,0
C 225,30,0

SF ../xpm/library_game/eye.xpm
SD ../xpm/library_game/eye_fermented.xpm
W0 ../xpm/weapon/bow_pulling_0.xpm
W1 ../xpm/weapon/bow_pulling_1.xpm
W2 ../xpm/weapon/bow_pulling_2.xpm
W3 ../xpm/weapon/bow_standby.xpm
DN ../xpm/door/door_wood.xpm
DS ../xpm/door/door_otherside.xpm
DE ../xpm/door/door_wood.xpm
DW ../xpm/door/door_otherside.xpm
LI ../xpm/heart.xpm
LO ../xpm/replay_button.xpm
WI ../xpm/win_game.xpm
11111111
11111311
11111111
        1111111111111111111111111
        1000000000110000000000001
        1011000001110000000000001
        1001000000000000000000001
N11111111011000001110000000000001
100000000011000001110111111111111
11110111111111011100000010001
11110111111111011101010010001
11000000110101011100000010001
10000000000000001100000010001
10000000000000001101010010001
1100000111010101111101111000111
11110111 1110101 101111010001
11111111 1111111 111111111111